################################################################################   
#  #                                                                           #  
#  #                                                                           #  
#  #                                                                           #  
#                                                                              #  
#                                                                              #  
#                                                                              #  
#                                                                              #  
#                                                                              #  
#                                                                              #  
#                                                                              #  
#                                                                              #  
#                                                                              #   
#                                                                              #  
#                                                                              #  
#                                                                              #  
#                                                                              #   
#                                                                              #  
#                                                                              #  
#                                                                              #  
#                                                                              #  
#                                                                              #  
#                                                                              #  
#                                                                              #  
#                                                                              #  
#                                                                              #  
#                                                                              #  
#                                                                              #  
#                                                                              #  
#                                                                              #  
#                                                                              #  
#                                                                              #  
#                                                                              #  
#                                                                              #  
################################################################################