# # # # # # # # # # # # # # # # # # # # # 
# o     @               #               #
# # #   # # # # #   #   #   # # # # # # # 
#               #   #   #   #           # 
# # # #   # # # # # # # #   #   #   #   # 
#                               #   #   # 
# # # # # # # # #   # # # # # # # # # # # 
#       #               #   #   #   #   # 
#   # # #   # # # # #   #   #   #       # 
#           #           #       #   #   # 
# # # # # # # #   # # # # # #   # # #   # 
#   #   #   #           #       #       # 
#   #   #   #   #   # # #   #   #   #   # 
#   #   #   #   #   #   #   #       #   # 
#       #   #   #       # # #   #   # # # 
#   #       #   #   #   #       #   #   # 
#   # # #       #   #   #   # # #   #   # 
#   #   #   #   #   #   #       #   #   # 
#   #   #   #   #   #   #   #   #   #   # 
#   #       #   #   #       #   #       # 
# # # # # # # # # # # # # # # # # # # # #
